大家さんは思春期！	水瀬るるう
かなみ育成中！	田口ホシノ
月夜にカカオシガレット	師走冬子
毎日が新選組！	おーはしるい
寺島さんは悟っている	浦津ゆうじ
おしかけツインテール	高津ケイタ
航海王子の優雅な船旅	ひらのあゆ
軍神ちゃんとよばないで	柳原満月
役職名はお嫁さん	G3井田
牧場OL	丸井まお
きみちゃんの味じまん	只野アカネ
あまてる！	毒田ペパ子
パパとあそぼう！	かより
かしこみかしこみ	幌倉さと
いにしえや浪漫堂	あろひろし
夕暮れ茶房紺色堂	アサミ・マート
わさんぼん	佐藤両々
妹のおシゴトは時給2000円	遠山えま
感染！ウイちゃん	かわのゆうすけ	ゲスト連載
レオタードって、恥ずかしくないですか？	いつみまお	ゲスト連載
白鳥くんはいつも崖っぷち	楯山ヒロコ	ゲスト連載
ふみのさんちの大黒柱	池田乾	ゲスト連載
