晴れのちシンデレラ	宮成楽
森田さんは無口	佐野妙
奥さまはアイドル	師走冬子
お姉ちゃんが来た	安西理晃
ト或ル夫婦ノ日乗	崎由けぇき
まほろばきっさ	tugeneko
ゴーゴーダイナマイツ	小池定路
宮尾さんは生えている	TOもえ
針棘クレミーと王の家	唯根
鋼鉄漫録	安西信行
海咲ライラック	険持ちよ
さかな＆ねこ	森井ケンシロウ
ついっとMARCH	真島悦也
白鳥ちゃん閲覧禁止っ！！	ひらふみ
おうちでごはん	スズキユカ
さつまと飼い主	o-ji
びわっこ自転車旅行記	大塚志郎
クマ・男子	胡桃ちの
おみ不思議夜話	南央美
司書メイド ミソノの図書館ぐらし	ミソノ
